################################
#g                   #         #
#                    #         #
#  ##  #####         #         #
#          #    ###  #   ###   #
#          #         #         #
#  #   T   #      ######       #
#  #       #           #   #   #
#  #########       #       #   #
#                  #       #   #
#                  #########   #
#            #                 #
#            #                 #
#         g  ########          #
#                              #
#                              #
#        ####  ####            #
#        #        #      G     #
#        #    S   #            #
#        #        #            #
#        ##########            #
#                              #
#           t                  #
#  ###########                 #
#  #         #     ####    #####
#  #    G    #     #           #
#  #         #     #           #
#  #         #     #           #
#  #  ########     #   t       #
#                  #           #
#                  #           #
################################